1111111
1CP0001
1C00E01
1111111