1 
11
101
10C1
1P001
100001
1E00001
11111111