11111111
1P00C0E1
10CC01C1
11111111