1111111111111
10000000000E1
10C0011000101
1000111C00001
1P01111C010C1
1111111111111