1111111111111
11111111111E1
1PC0000000001
1100111C10011
1101111C000C1
1000000000001
1000000000001
1000000000001
1000000000001
1000000000001
1111111111111
