11111111111111111111111
10001010000000000000001
10000000000000000000001
10000001111111111111111
1P010000000001111000001
10000011000000000000001
10000000000111000000001
10000000000C00000000E01
11111111111111111111111