111111
100E01
1P0001
1000C1
111111